NO ./assets/textures/NO.xpm
SO ./assets/textures/NO.xpm
WE ./assets/textures/NO.xpm
EA ./assets/textures/NO.xpm
F 255,255,255
C      255,0,255   
111111111111111
100000000000001
110111000001111
100011111100001
111000000W11111
111111111111111
