NO ./assets/textures/NO.xpm
SO ./assets/textures/NO.xpm
WE ./assets/textures/NO.xpm
EA ./assets/textures/NO.xpm
F 255,255,255
C 255,0,255
11
101        1
1001111111101
1000000000001
1111111111111
