NO ./assets/textures/NO.xpm
SO ./assets/textures/NO.xpm
WE ./assets/textures/NO.xpm
EA ./assets/textures/NO.xpm
F 255,255,255
C 255,0,255
11
101        1
1N01111111101
10000000000S1
1111111111111
